vareil_a	cormer_b
mendoz_r	nicola_o
yaiche_c	lesbro_h
varada_j	kebe_m
mazeau_l	merdji_o
henriq_c	ciprin_l
barat_v		flouir_a
belthi_a	foltyn_a
wittma_t	baudic_j
louvoi_a	mikart_j
damhet_a	leandr_a
dubois_o	faqir_a
bakhti_b	labbe_r
innoce_r	jully_a
chauta_m	attivi_j
douill_a	banet_l
owona-_a	derman_e
ta_e		gras_q
greine_l	ozarow_b
abita_a		chowdh_f
carlot_a	russo_f
maillo_j	orfila_c
andrio_e	adjou_k
mailha_t	bardou_a
goy_j		kiaies_a
ngahan_d	leliev_w
lehuen_a	fiocco_p
huez_m		baille_v
mailah_t	corbel_a
baruh_m		anseau_a
senhaj_h	aiguep_g
riquer_p	aubert_o
bosma_f		moriss_m
estano_p	luong_p
lemair_b	abita_a
moriss_m	gussag_a
alexan_e	folin_a
nigro_t		jouffr_a
chaban_t	benoit_i
lees_m		gardet_p
orfila_c	nguy_o
chapel_e	toubou_z
bennou_y	bigare_b
bouron_a	moutou_s
begey_p		roche-_x
nguye_5		vo_c
pierqu_b	legend_m
girode_a	mendoz_a
jully_a		liotie_t
boulay_p	fresne_m
jouffr_a	barroy_t
giovan_a	le-que_r
crepin_g	xu_e
attivi_j	carlot_a
fiocco_p	gemsa_e
flouir_a	jacque_l
guervi_t	baruh_m
mikart_j	san_p
bureau_a	viovy_n
moutou_s	eisenb_n
aubert_h	delhom_b
datich_b	roberj_j
gomes_a		chapel_e
cengiz_m	mechin_e
carric_l	buisso_j
pageri_t	morali_b
moisan_a	eutrop_a
plante_m	capes_h
anseau_a	varada_j
san_p		lemair_b
le-que_r	boissi_v
mancer_s	datich_b
perell_a	lamatt_v
treibe_a	grenou_a
batche_c	vallat_p
sauvar_g	legoua_g
yiu_t		chojka_p
tanawa_a	widaws_b
daumal_l	diallo_t
tran__		durot_m
vidal_m		morand_j
duprat_r	paultr_h
corbel_a	demode_m
pochez_a	raffal_m
neveu_b		barat_v
weiss_a		chambo_b
baudri_j	vareil_a
bardou_a	frant_g
oufkir_m	millio_b
leguiz_r	ricime_l
albert_c	verax_a
caltea_t	bosma_f
lebraz_g	ramael_r
moreau_2	merind_g
benoit_i	weiss_a
diallo_t	chaban_t
grenou_a	rees_a
cohen_p		lejoux_j
gras_q		alexan_e
lesbro_h	bernie_r
sobral_a	chemla_c
bernie_r	labat_r
ribeir_d	pierqu_b
ciprin_l	tang_q
boillo_l	dimach_c
capes_h		gomes_a
ricime_l	anakok_d
peicho_d	downey_j
baille_v	dehlav_a
dekeys_d	moisan_a
audine_g	jonath_c
chavan_p	dioman_j
josso_t		benyou_s
lobry_a		rybins_h
rees_a		pham_l
boissi_v	marsai_p
luong_p		olivie_b
tahri_m		lafitt_t
raffal_m	andrio_e
labbe_r		elbahr_s
durot_m		marque_o
bravo_j		chamay_t
marty_l		gaudro_m
morand_j	plante_m
lugard_o	henriq_c
olivie_b	bennou_y
elvang_s	louzou_k
petit_u		antin_g
bernet_s	nguyen_9
villai_p	adam_a
mateos_n	cohen_p
vuu_w		boutin_a
aiguep_g	gueye_d
charle_h	virsol_t
saint-_l	peicho_d
dehlav_a	guihen_t
ozarow_b	lao_d
kedemo_l	bidon_a
roberj_j	huez_m
fresne_m	bakhti_b
torre_a		nguye_5
beloua_i	goy_j
torsel_h	perell_a
debec_a		michau_n
liotie_t	boillo_l
frant_g		sauvee_e
fauchi_a	le_i
lemenn_v	girard_1
joly_p		manuel_d
chalab_k	maillo_j
piriou_a	caster_d
adon_r		pageri_t
anakok_d	luu_j
jonath_c	mailah_t
demode_m	lugand_j
michel_l	baudri_j
elbahr_s	dugaug_q
antin_g		audine_g
marsai_p	corret_j
lejay_s		kedemo_l
eisenb_n	bouron_a
nicola_o	petit_s
abdoul_a	pichon_h
lafitt_t	matoss_l
verax_a		bakry_r
charle_m	wittma_t
wakim_w		elvang_s
gilet-_g	albert_k
ghabro_c	owona-_a
beylie_m	tchemy_s
gueye_d		greine_l
bastie_c	sobral_a
buisso_j	cossar_m
billio_r	innoce_r
toubou_z	mendoz_r
bounac_m	lugard_o
norman_g	duprat_r
charig_n	torre_a
matoss_l	yang_e
leandr_a	ngahan_d
ingabi_c	vanste_g
doming_t	lauzei_q
delhom_b	palusc_a
sauvee_e	ung_k
ottin_b		estano_p
legend_m	chauta_m
niezab_a	billio_r
nguyen_9	lair_v
vanste_g	cetre_c
d-haus_h	yiu_t
kebe_m		damhet_a
patte_l		dubois_o
youino_f	marty_l
virsol_t	daumal_l
chiffo_b	fauchi_l
mechin_e	gbagui_a
lauzei_q	lehuen_a
lejoux_j	luu_k
lair_v		caltea_t
halilo_h	kopf_e
adjou_k		carric_l
baudic_j	tahri_m
roche-_x	cueill_s
viovy_n		fauchi_a
mendoz_a	peron_g
deutsc_t	rakows_d
daval-_g	bravo_j
jauffr_a	louvoi_a
herve_d		poumar_a
cheval_4	dousso_a
michau_n	adon_r
vallat_p	grondi_d
kopf_e		ammar_m
ung_k		charig_n
merind_g	mateos_n
xu_e		chavan_p
bidon_a		d-haus_h
adam_a		yaiche_c
elbouk_z	charle_h
angela_b	albert_c
eat_k		begey_p
chojka_p	mancer_s
petit_s		sriska_n
bigare_b	bernet_s
paultr_h	mailha_t
lagorc_m	lebraz_g
louzou_k	lees_m
ramael_r	piriou_a
luu_k		vuu_w
lebeur_a	cheval_4
fanich_b	chalab_k
cueill_s	chiffo_b
oberto_d	josso_t
tchemy_s	tran__
aubert_o	gilet-_g
russo_f		vidal_m
kiaies_a	deutsc_t
marque_o	beylie_m
chamay_t	lobry_a
rakows_d	treibe_a
mary_j		petit_u
banet_l		pochez_a
hingra_f	abitbo_t
barroy_t	fanich_b
millio_b	oufkir_m
palusc_a	joly_p
sriska_n	herve_d
ducrot_t	charle_m
yang_e		ottin_b
girard_1	daval-_g
bah_e		patte_l
toussa_b	epalle_c
chemla_c	bounac_m
gemsa_e		gay_d
vo_c		debec_a
nguy_o		schrav_e
abitbo_t	guervi_t
leliev_w	wakim_w
gardet_p	mazeau_l
caster_d	crepin_g
boulay_a	sauvar_g
baccam_f	gomez_b
legoua_g	bureau_a
lugand_j	norman_g
pichon_h	boulay_p
dioman_j	ducrot_t
jacque_l	chabro_a
eutrop_a	belthi_a
maffer_a	toussa_b
morali_b	aubert_h
grebot_f	deverg_a
deriva_e	lay_a
manuel_d	angela_b
downey_j	ribeir_d
zhang_f		mary_j
luu_j		perris_p
derman_e	elbouk_z
folin_a		senhaj_h
cormer_b	michel_l
peron_g		tanawa_a
perris_p	cengiz_m
caussa_j	batche_c
gay_d		douill_a
gbagui_a	abdoul_a
lay_a		jauffr_a
epalle_c	lejay_s
chambo_b	halilo_h
le_i		ta_e
poumar_a	hingra_f
merdji_o	bah_e
schrav_e	dekeys_d
aurry_j		deriva_e
faqir_a		oberto_d
labat_r		lemenn_v
cossar_m	maffer_a
grondi_d	beloua_i
rybins_h	saint-_l
deverg_a	boulay_a
guihen_t	youino_f
benyou_s	caussa_j
lao_d		eat_k
foltyn_a	moreau_2
gomez_b		lebeur_a
dugaug_q	doming_t
cetre_c		giovan_a
bakry_r		riquer_p
albert_k	zhang_f
lamatt_v	villai_p
tang_q		lagorc_m
gussag_a	aurry_j
chabro_a	baccam_f
corret_j	ingabi_c
dimach_c	grebot_f
chowdh_f	neveu_b
ammar_m		ghabro_c
gaudro_m	bastie_c
dousso_a	nigro_t
pham_l		girode_a
boutin_a	torsel_h
fauchi_l	niezab_a
widaws_b	leguiz_r
